0 0 0 0 0 0 0 0 0 0 0 0 0 0 0 0 0 0 0 
0 0 0 0 0 0 0 0 0 0 0 0 0 0 0 0 0 0 0 
0 0 0 0 0 0 0 0 0 0 0 0 0 0 0 0 0 0 0 
0 0 0 0 0 0 0 0 0 0 0 0 0 0 0 0 0 0 0 
0 0 0 0 0 0 0 0 0 0 0 0 0 0 3 4 3 4 3 
0 0 0 0 0 0 0 0 0 0 0 0 0 0 3 3 3 3 3 
0 0 0 0 0 0 0 0 0 0 0 0 0 0 3 2 2 2 3 
0 0 0 0 0 0 0 0 0 0 0 0 0 0 3 2 2 2 3 
0 0 0 0 0 0 0 0 0 0 0 0 0 0 3 3 3 3 3 
0 0 0 0 0 0 0 0 0 0 0 0 0 0 3 2 0 2 3 
0 0 0 0 0 0 0 0 0 0 0 0 0 3 3 2 4 2 3 
0 0 0 0 0 0 0 0 0 0 0 0 3 3 2 2 2 2 3 
0 0 0 0 0 0 0 0 0 0 0 3 3 2 2 2 2 2 3 
0 0 0 0 0 0 0 0 0 0 0 3 0 0 0 0 0 4 3 
0 0 0 0 0 0 0 0 0 0 3 3 2 2 4 0 4 2 3 
0 0 0 0 0 0 0 0 0 3 3 0 2 2 2 4 2 2 3 
0 0 0 0 0 0 0 0 3 3 3 4 2 2 2 2 2 2 3 
0 0 0 0 0 0 0 3 3 3 3 3 3 3 3 3 3 3 3 
0 0 0 0 0 0 0 0 0 0 0 0 0 0 0 0 0 0 0  